11111111111111111
1C0C0E0000C0C0001
10100100000101C01
1C010101010001001
1000C00C00N001001
100C0101011110001
100101010C0001111
1P010C01011110001
11111111111111111
