11111111111111111111
10N10010C1C000000011
11C00001000111100001
10000C0000C001100011
1C111C000000000C1111
10000000000000000001
1000C00E011111000001
11111111000000010011
1000C0000C0111100C01
100111C00001C1000001
11000P00011100001001
11111111111111111111
